111111111111111
1E0000000000001
101001010010001
101001001010101
1P0000000C00CC1
101001001010101
100000000C00CC1
101001001010101
100000000C00CC1
111111111111111