111111111111111111111111111111111111111111111111111111
10000000000P100000000000100000000000100000000000111111
100000000000000000000000000000000000000000000000000001
100000000000000000000000000000000000000000000000000001
100000000000000000000000000000000000000000000000000001
100000000000000000000000000000000000000000000000000001
10000000000000000C000000000000000000000000000000000001
100000000000000000000000000000000000000000000000000001
111011111111111111111111111111111111111111111111111111
111011111111111111111111111111111111111111111111111111
100000000000100000000000100000000000100000000000111111
100000000000000000000000000000000000000000000000000001
100000000000000000000000000000000000000000000000000001
100000000000000000000000000000000000000000000000000001
100000000000000000000000000000000000000000000000000001
10000000000000000C000000000000000000000000000000000001
100000000000000000000000000000000000000000000000000001
111011111111111111111111111111111111111111111111111111
111011111111111111111111111111111111111111111111111111
100000000000100000000000100000000000100000000000111111
100000000000000000000000000000000000000000000000000001
100000000000000000000000000000000000000000000000000001
100000000000000000000000000000000000000000000000000001
100000000000000000000000000000000000000000000000000001
10000000000000000C000000000000000000000000000000000001
100000000000000000000000000000000000000000000000000001
111011111111111111111111111111111111111111111111111111
111011111111111111111111111111111111111111111111111111
100000000000100000000000100000000000100000000000111111
100000000000000000000000000000000000000000000000000001
100000000000000000000000000000000000000000000000000001
100000000000000000000000000000000000000000000000000001
100000000000000000000000000000000000000000000000000001
10000000000000000C000000000000000000000000000000000001
100000000000000000000000000000000000000000000000000001
111011111111111111111111111111111111111111111111111111
111011111111111111111111111111111111111111111111111111
100000000000100000000000100000000000100000000000111111
100000000000000000000000000000000000000000000000000001
100000000000000000000000000000000000000000000000000001
100000000000000000000000000000000000000000000000000001
100000000000000000000000000000000000000000000000000001
10000000000000000C000000000000000000000000000000000001
100000000000000000000000000000000000000000000000000001
111011111111111111111111111111111111111111111111111111
111011111111111111111111111111111111111111111111111111
100000000000100000000000100000000000100000000000111111
100000000000000000000000000000000000000000000000000001
100000000000000000000000000000000000000000000000000001
100000000000000000000000000000000000000000000000000001
100000000000000000000000000000000000000000000000000001
10000000000000000C000000000000000000000000000000000001
100000000000000000000000000000000000000000000000000001
111011111111111111111111111111111111111111111111111111
111011111111111111111111111111111111111111111111111111
100000000000100000000000100000000000100000000000111111
100000000000000000000000000000000000000000000000000001
100000000000000000000000000000000000000000000000000001
100000000000000000000000000000000000000000000000000001
100000000000000000000000000000000000000000000000000001
10000000000000000C000000000000000000000000000000000001
100000000000000000000000000000000000000000000000000001
111011111111111111111111111111111111111111111111111111
111011111111111111111111111111111111111111111111111111
100000000000100000000000100000000000100000000000111111
100000000000000000000000000000000000000000000000000001
100000000000000000000000000000000000000000000000000001
100000000000000000000000000000000000000000000000000001
100000000000000000000000000000000000000000000000000001
10000000000000000C000000000000000000000000000000000001
100000000000000000000000000000000000000000000000000001
111011111111111111111111111111111111111111111111111111
111011111111111111111111111111111111111111111111111111
100000000000100000000000100000000000100000000000111111
100000000000000000000000000000000000000000000000000001
100000000000000000000000000000000000000000000000000001
100000000000000000000000000000000000000000000000000001
100000000000000000000000000000000000000000000000000001
10000000000000000C000000000000000000000000000000000001
100000000000000000000000000000000000000000000000000001
111011111111111111111111111111111111111111111111111111
111011111111111111111111111111111111111111111111111111
100000000000100000000000100000000000100000000000111111
100000000000000000000000000000000000000000000000000001
100000000000000000000000000000000000000000000000000001
100000000000000000000000000000000000000000000000000001
100000000000000000000000000000000000000000000000000001
10000000000000000C000000000000000000000000000000000001
100000000000000000000000000000000000000000000000000001
111011111111111111111111111111111111111111111111111111
111011111111111111111111111111111111111111111111111111
100000000000100000000000100000000000100000000000111111
100000000000000000000000000000000000000000000000000001
100000000000000000000000000000000000000000000000000001
100000000000000000000000000000000000000000000000000001
100000000000000000000000000000000000000000000000000001
10000000000000000C000000000000000000000000000000000001
100000000000000000000000000000000000000000000000000001
111011111111111111111111111111111111111111111111111111
111011111111111111111111111111111111111111111111111111
100000000000100000000000100000000000100000000000111111
100000000000000000000000000000000000000000000000000001
100000000000000000000000000000000000000000000000000001
100000000000000000000000000000000000000000000000000001
100000000000000000000000000000000000000000000000000001
10000000000000000C000000000000000000000000000000000001
100E00000000000000000000000000000000000000000000000001
111111111111111111111111111111111111111111111111111111