111111111111111
1000X0000000001
101001010010001
10100100101X101
1P000000XC00CC1
101001001010101
100X00000C00CC1
101001001010101
1000E0000C00CC1
111111111111111