1111111111111111
1000P00000000011
1111X0000C000E01
1001C00X11000101
1111111111111111